,machine_num,job_num,operation_num,begin_time,end_time,operation_time
0,1,4,1,0,9,9
0,1,24,1,9,145,136
0,1,15,1,145,315,170
0,1,3,1,315,331,16
0,1,12,1,331,369,38
0,1,9,1,369,405,36
0,1,25,1,405,618,213
0,1,1,1,618,626,8
0,1,12,2,626,702,76
0,1,3,2,702,712,10
0,1,4,2,712,721,9
0,1,9,2,721,831,110
0,1,15,2,831,975,144
0,1,16,1,975,1105,130
0,1,29,2,1165,1271,106
0,1,14,2,1271,1383,112
0,1,11,2,1383,1474,91
0,1,22,1,1474,1637,163
0,1,17,2,1637,1778,141
0,1,5,2,1778,1846,68
0,1,7,2,2009,2109,100
0,1,43,7,2115,2166,51
0,1,46,7,2845,2878,33
0,1,37,7,3434,3472,38
0,1,40,7,4215,4277,62
0,2,20,1,0,131,131
0,2,2,2,131,140,9
0,2,6,1,140,171,31
0,2,23,1,171,390,219
0,2,13,1,390,444,54
0,2,27,1,444,605,161
0,2,8,1,605,659,54
0,2,24,2,659,841,182
0,2,13,2,841,943,102
0,2,21,2,948,1034,86
0,2,6,2,1034,1089,55
0,2,14,1,1089,1221,132
0,2,19,2,1221,1438,217
0,2,5,1,1438,1460,22
0,2,18,1,1460,1639,179
0,2,22,2,1639,1728,89
0,2,27,2,1728,1863,135
0,2,25,2,1863,1980,117
0,3,2,3,140,525,385
0,3,12,3,702,863,161
0,3,9,3,863,1055,192
0,3,4,3,1055,1810,755
0,3,3,3,1810,2171,361
0,3,13,3,2171,2385,214
0,3,8,3,2385,2588,203
0,3,11,3,2588,2712,124
0,3,6,3,2712,2798,86
0,3,10,3,2798,2998,200
0,3,7,3,2998,3073,75
0,3,1,3,3073,3912,839
0,3,5,3,3912,4006,94
0,3,3,9,5054,5061,7
0,3,2,9,7070,7076,6
0,3,9,9,8147,8173,26
0,3,4,9,9889,9896,7
0,3,8,9,11097,11147,50
0,3,11,9,11911,11938,27
0,3,10,9,12893,12915,22
0,3,12,9,13841,13863,22
0,3,13,9,14766,14809,43
0,3,6,9,16139,16168,29
0,3,7,9,17805,17856,51
0,3,5,9,19615,19644,29
0,3,1,9,23941,23944,3
0,4,32,2,71,165,94
0,4,36,2,275,422,147
0,4,39,2,422,576,154
0,4,38,2,576,727,151
0,4,34,2,727,856,129
0,4,12,4,863,934,71
0,4,2,4,934,978,44
0,4,57,2,978,1039,61
0,4,30,2,1039,1152,113
0,4,43,2,1152,1237,85
0,4,9,4,1237,1384,147
0,4,54,2,1385,1533,148
0,4,35,2,1533,1667,134
0,4,55,2,1667,1730,63
0,4,48,2,1748,1868,120
0,4,42,2,1871,2005,134
0,4,4,4,2005,2038,33
0,4,56,2,2038,2103,65
0,4,3,4,2171,2210,39
0,4,51,2,2210,2369,159
0,4,37,2,2369,2499,130
0,4,46,2,2499,2568,69
0,4,45,2,2568,2719,151
0,4,50,2,2719,2836,117
0,4,8,4,2836,2931,95
0,4,47,2,2931,3027,96
0,4,44,2,3027,3147,120
0,4,49,2,3147,3299,152
0,4,33,2,3299,3390,91
0,4,13,4,3390,3537,147
0,4,6,4,3537,3710,173
0,4,31,2,3710,3836,126
0,4,11,4,3836,3992,156
0,4,40,2,3992,4116,124
0,4,7,4,4116,4186,70
0,4,10,4,4186,4316,130
0,4,52,2,4316,4462,146
0,4,53,2,4462,4605,143
0,4,5,4,4605,4712,107
0,4,1,4,4712,4728,16
0,4,41,2,4728,4832,104
0,5,26,3,780,1085,305
0,5,2,5,1085,1107,22
0,5,24,3,1107,1299,192
0,5,12,5,1299,1357,58
0,5,9,5,1384,1476,92
0,5,2,6,1476,2328,852
0,5,20,3,2328,2587,259
0,5,29,3,2587,2958,371
0,5,3,5,2958,2980,22
0,5,8,5,2980,3069,89
0,5,3,6,3069,3780,711
0,5,9,6,3780,4701,921
0,5,15,3,4701,4928,227
0,5,4,5,4928,4947,19
0,5,11,5,4947,5005,58
0,5,19,3,5005,5210,205
0,5,28,3,5210,5622,412
0,5,14,3,5622,5996,374
0,5,8,6,5996,6430,434
0,5,16,3,6430,6660,230
0,5,11,6,6660,7448,788
0,5,6,5,7448,7542,94
0,5,4,6,7542,8164,622
0,5,12,6,8164,8750,586
0,5,10,5,8750,8810,60
0,5,27,3,8810,9154,344
0,5,23,3,9154,9601,447
0,5,13,5,9601,9662,61
0,5,13,6,9662,10423,761
0,5,17,3,10423,10734,311
0,5,10,6,10734,11142,408
0,5,22,3,11142,11417,275
0,5,18,3,11417,11729,312
0,5,25,3,11729,11879,150
0,5,5,5,11879,11914,35
0,5,6,6,11914,12500,586
0,5,21,3,12500,12911,411
0,5,7,5,12911,12965,54
0,5,1,5,12965,12980,15
0,5,5,6,12980,13333,353
0,5,7,6,13333,14157,824
0,5,1,6,14157,14602,445
0,6,102,5,826,1333,507
0,6,91,5,1535,1918,383
0,6,103,5,2029,2300,271
0,6,2,7,2328,3133,805
0,6,88,5,3133,3659,526
0,6,3,7,3780,4239,459
0,6,112,5,4239,4624,385
0,6,9,7,4701,5171,470
0,6,101,5,5171,5744,573
0,6,94,5,5744,6389,645
0,6,8,7,6430,6964,534
0,6,86,5,6964,7407,443
0,6,11,7,7448,8199,751
0,6,4,7,8199,8875,676
0,6,12,7,8875,9355,480
0,6,104,5,9355,10010,655
0,6,105,5,10010,10664,654
0,6,87,5,10664,11077,413
0,6,10,7,11142,12134,992
0,6,13,7,12134,13102,968
0,6,6,7,13102,13462,360
0,6,110,5,13462,14094,632
0,6,92,5,14094,14594,500
0,6,111,5,14594,15147,553
0,6,7,7,15147,16098,951
0,6,5,7,16098,16766,668
0,6,96,4,16766,17345,579
0,6,113,5,17345,17693,348
0,6,107,5,17693,18087,394
0,6,115,5,18087,18718,631
0,6,109,5,18718,19118,400
0,6,90,5,19118,19630,512
0,6,98,5,19630,20005,375
0,6,114,5,20005,20393,388
0,6,95,5,20393,20978,585
0,6,108,5,20978,21531,553
0,6,97,5,21531,21776,245
0,6,1,7,21776,22400,624
0,6,100,5,22400,22824,424
0,6,106,5,22824,23266,442
0,6,117,5,23266,23649,383
0,6,116,5,23649,23921,272
0,6,89,5,23921,24210,289
0,6,93,5,24210,24540,330
0,6,99,5,24540,25121,581
0,7,3,8,4239,5054,815
0,7,2,8,5054,7070,2016
0,7,9,8,7070,8147,1077
0,7,4,8,8875,9889,1014
0,7,8,8,9889,11097,1208
0,7,11,8,11097,11911,814
0,7,10,8,12134,12893,759
0,7,12,8,12893,13841,948
0,7,13,8,13841,14766,925
0,7,6,8,14766,16139,1373
0,7,7,8,16139,17805,1666
0,7,5,8,17805,19615,1810
0,7,1,8,22400,23941,1541
0,8,126,2,202,543,341
0,8,125,2,543,689,146
0,8,15,6,5066,5145,79
0,8,13,10,14809,14924,115
0,9,120,1,0,82,82
0,9,14,6,6068,6147,79
0,9,2,10,7076,7096,20
0,10,128,1,0,91,91
0,10,124,1,91,216,125
0,10,20,6,3224,3306,82
0,10,8,10,11147,11228,81
0,10,18,6,11817,11946,129
0,10,10,10,12915,12998,83
0,10,21,6,13003,13082,79
0,11,19,6,5324,5404,80
0,11,22,6,11504,11590,86
0,11,10,11,12998,13050,52
0,11,12,10,13863,13983,120
0,11,6,11,16247,16305,58
0,11,7,11,17962,18018,56
0,12,118,2,196,330,134
0,12,147,2,330,502,172
0,12,24,6,1476,1624,148
0,12,9,11,8254,8368,114
0,12,27,6,9286,9455,169
0,13,123,1,0,88,88
0,13,151,1,88,224,136
0,13,125,1,224,431,207
0,13,2,11,7096,7128,32
0,13,13,11,14924,14971,47
0,13,6,10,16168,16247,79
0,14,119,1,0,83,83
0,14,126,1,83,202,119
0,14,7,10,17856,17962,106
0,15,129,1,0,122,122
0,15,147,1,122,229,107
0,15,151,2,229,337,108
0,15,28,6,5738,5861,123
0,16,119,2,83,216,133
0,16,26,6,1186,1286,100
0,16,3,10,5061,5091,30
0,16,16,6,6756,6859,103
0,16,9,10,8173,8254,81
0,16,4,11,9914,9927,13
0,16,25,6,12022,12111,89
0,16,11,11,12111,12170,59
0,17,129,2,122,424,302
0,17,23,6,9730,9822,92
0,17,4,10,9896,9914,18
0,17,1,10,23944,23990,46
0,18,127,1,0,140,140
0,18,127,2,140,448,308
0,18,124,2,448,563,115
0,18,3,11,5091,5121,30
0,18,12,11,13983,14030,47
0,18,5,10,19644,19769,125
0,19,122,1,0,86,86
0,19,121,1,86,172,86
0,19,29,6,3038,3125,87
0,19,17,6,10903,11037,134
0,19,8,11,11228,11296,68
0,19,11,10,11938,12032,94
0,19,5,11,19769,19822,53
0,19,1,11,23990,24015,25
0,20,26,7,1286,1477,191
0,20,24,7,1624,1815,191
0,20,29,7,3125,3306,181
0,20,20,7,3306,3421,115
0,20,3,12,5121,5144,23
0,20,15,7,5145,5276,131
0,20,19,7,5404,5488,84
0,20,28,7,5861,6010,149
0,20,14,7,6147,6227,80
0,20,16,7,6859,6999,140
0,20,2,12,7128,7171,43
0,20,9,12,8368,8470,102
0,20,27,7,9455,9536,81
0,20,23,7,9822,10042,220
0,20,4,12,10042,10079,37
0,20,17,7,11037,11213,176
0,20,8,12,11296,11396,100
0,20,22,7,11590,11807,217
0,20,18,7,11946,12043,97
0,20,25,7,12111,12234,123
0,20,11,12,12234,12346,112
0,20,21,7,13082,13294,212
0,20,10,12,13294,13379,85
0,20,12,12,14030,14146,116
0,20,13,12,14971,15074,103
0,20,6,12,16305,16364,59
0,20,7,12,18018,18161,143
0,20,5,12,19822,19883,61
0,20,1,12,24015,24031,16
0,21,24,9,1868,1966,98
0,21,14,9,6305,6381,76
0,21,5,13,19883,20037,154
0,22,9,13,8470,8599,129
0,22,17,9,11273,11367,94
0,22,18,9,12119,12211,92
0,22,25,9,12298,12378,80
0,22,11,13,12378,12534,156
0,22,13,13,15074,15212,138
0,22,1,13,24031,24138,107
0,23,26,9,3840,4032,192
0,23,27,9,9637,9722,85
0,23,23,9,10111,10207,96
0,23,8,13,11396,11626,230
0,24,15,9,5352,5529,177
0,24,28,9,6109,6184,75
0,24,4,13,10079,10282,203
0,24,22,9,11861,12046,185
0,24,10,13,13379,13469,90
0,24,12,13,14146,14310,164
0,25,20,9,3513,3583,70
0,25,3,13,5144,5287,143
0,25,19,9,5534,5626,92
0,25,16,9,7069,7149,80
0,25,2,13,7171,7307,136
0,26,29,9,3393,3483,90
0,26,21,9,13339,13417,78
0,26,6,13,16364,16477,113
0,26,7,13,18161,18273,112
0,27,36,4,432,536,104
0,27,32,4,536,618,82
0,27,26,4,1085,1141,56
0,27,38,4,1237,1333,96
0,27,24,4,1333,1403,70
0,27,39,4,1768,1863,95
0,27,57,4,1882,1955,73
0,27,43,4,1984,2057,73
0,27,42,4,2057,2158,101
0,27,55,4,2158,2236,78
0,27,34,4,2236,2274,38
0,27,35,4,2274,2344,70
0,27,54,4,2570,2662,92
0,27,48,4,2692,2769,77
0,27,46,4,2769,2809,40
0,27,50,4,2843,2925,82
0,27,29,4,2958,2998,40
0,27,45,4,2998,3096,98
0,27,20,4,3096,3147,51
0,27,56,4,3147,3242,95
0,27,44,4,3242,3329,87
0,27,37,4,3329,3382,53
0,27,33,4,3398,3443,45
0,27,49,4,3443,3541,98
0,27,30,4,3541,3618,77
0,27,51,4,3618,3715,97
0,27,47,4,3715,3781,66
0,27,31,4,3853,3916,63
0,27,40,4,4129,4182,53
0,27,52,4,4476,4567,91
0,27,53,4,4616,4713,97
0,27,15,4,4928,4990,62
0,27,41,4,4990,5076,86
0,27,19,4,5210,5244,34
0,27,28,4,5622,5654,32
0,27,14,4,5996,6033,37
0,27,16,4,6660,6689,29
0,27,27,4,9154,9202,48
0,27,23,4,9601,9680,79
0,27,17,4,10734,10811,77
0,27,22,4,11417,11460,43
0,27,18,4,11729,11758,29
0,27,25,4,11879,11945,66
0,27,21,4,12911,12960,49
0,28,36,8,644,715,71
0,28,32,8,746,782,36
0,28,26,5,1141,1186,45
0,28,24,5,1403,1476,73
0,28,38,8,1476,1510,34
0,28,39,8,1976,2028,52
0,28,43,8,2166,2225,59
0,28,57,8,2225,2290,65
0,28,55,8,2332,2399,67
0,28,42,8,2417,2456,39
0,28,35,8,2472,2547,75
0,28,34,8,2547,2589,42
0,28,54,8,2751,2794,43
0,28,46,8,2878,2947,69
0,28,29,5,2998,3038,40
0,28,50,8,3038,3118,80
0,28,20,5,3147,3224,77
0,28,45,8,3224,3295,71
0,28,48,8,3295,3348,53
0,28,56,8,3363,3431,68
0,28,37,8,3472,3543,71
0,28,44,8,3543,3603,60
0,28,49,8,3627,3703,76
0,28,33,8,3703,3780,77
0,28,30,8,3780,3817,37
0,28,51,8,3820,3872,52
0,28,47,8,3872,3908,36
0,28,31,8,4065,4106,41
0,28,40,8,4277,4328,51
0,28,52,8,4692,4748,56
0,28,53,8,4844,4871,27
0,28,15,5,4990,5066,76
0,28,41,8,5159,5196,37
0,28,19,5,5244,5324,80
0,28,28,5,5654,5738,84
0,28,14,5,6033,6068,35
0,28,16,5,6689,6756,67
0,28,27,5,9202,9286,84
0,28,23,5,9680,9730,50
0,28,17,5,10811,10903,92
0,28,22,5,11460,11504,44
0,28,18,5,11758,11817,59
0,28,25,5,11945,12022,77
0,28,21,5,12960,13003,43
0,29,129,3,424,634,210
0,29,122,3,704,823,119
0,29,120,3,841,960,119
0,29,128,3,960,1161,201
0,29,123,4,1161,1370,209
0,29,147,3,1370,1477,107
0,29,120,4,1477,1606,129
0,29,151,3,1606,1764,158
0,29,122,4,1764,1934,170
0,29,151,4,1934,2088,154
0,29,118,3,2088,2203,115
0,29,127,5,2203,2460,257
0,29,129,5,2460,2704,244
0,29,122,5,2704,2756,52
0,29,121,3,2756,2826,70
0,29,124,3,2826,2974,148
0,29,121,4,2974,3061,87
0,29,123,6,3061,3223,162
0,29,120,6,3223,3442,219
0,29,121,6,3442,3586,144
0,29,126,3,3586,3787,201
0,29,26,8,3787,3840,53
0,29,122,6,3840,4079,239
0,29,126,4,4079,4238,159
0,29,119,6,4238,4368,130
0,29,128,4,4368,4657,289
0,29,148,6,4657,4793,136
0,29,125,6,4793,4993,200
0,29,151,6,4993,5176,183
0,29,147,6,5176,5453,277
0,29,19,8,5488,5534,46
0,29,128,5,5534,5849,315
0,29,118,6,5849,6128,279
0,29,27,8,9536,9637,101
0,29,18,8,12043,12119,76
0,30,123,3,203,333,130
0,30,127,3,448,631,183
0,30,129,4,634,768,134
0,30,119,3,768,921,153
0,30,127,4,921,1094,173
0,30,148,3,1094,1244,150
0,30,125,3,1244,1309,65
0,30,123,5,1370,1439,69
0,30,147,4,1477,1690,213
0,30,120,5,1690,1749,59
0,30,147,5,1749,1825,76
0,30,24,8,1825,1868,43
0,30,148,4,1868,2037,169
0,30,148,5,2037,2079,42
0,30,151,5,2088,2161,73
0,30,118,4,2203,2284,81
0,30,118,5,2284,2330,46
0,30,119,4,2330,2564,234
0,30,125,4,2564,2702,138
0,30,119,5,2702,2741,39
0,30,125,5,2741,2781,40
0,30,121,5,3061,3101,40
0,30,124,4,3101,3216,115
0,30,124,5,3216,3254,38
0,30,29,8,3306,3393,87
0,30,20,8,3421,3513,92
0,30,124,6,3513,3756,243
0,30,126,5,4238,4408,170
0,30,15,8,5276,5352,76
0,30,28,8,6010,6109,99
0,30,14,8,6227,6305,78
0,30,16,8,6999,7069,70
0,30,23,8,10042,10111,69
0,30,17,8,11213,11273,60
0,30,22,8,11807,11861,54
0,30,25,8,12234,12298,64
0,30,21,8,13294,13339,45
0,31,32,1,0,71,71
0,31,38,1,71,153,82
0,31,36,1,153,275,122
0,31,39,1,275,389,114
0,31,32,3,389,405,16
0,31,36,3,422,432,10
0,31,35,1,432,511,79
0,31,33,1,511,612,101
0,31,34,1,612,674,62
0,31,56,1,674,750,76
0,31,57,1,750,842,92
0,31,43,1,842,964,122
0,31,30,1,964,1010,46
0,31,49,1,1010,1102,92
0,31,46,1,1102,1226,124
0,31,38,3,1226,1237,11
0,31,44,1,1237,1304,67
0,31,54,1,1304,1385,81
0,31,45,1,1385,1484,99
0,31,55,1,1484,1570,86
0,31,51,1,1570,1699,129
0,31,48,1,1699,1748,49
0,31,34,3,1748,1755,7
0,31,39,3,1755,1768,13
0,31,42,1,1768,1871,103
0,31,57,3,1871,1882,11
0,31,52,1,1882,1968,86
0,31,43,3,1968,1984,16
0,31,55,3,1984,1996,12
0,31,35,3,1996,2004,8
0,31,42,3,2005,2016,11
0,31,50,1,2016,2128,112
0,31,37,1,2128,2244,116
0,31,47,1,2244,2356,112
0,31,31,1,2356,2415,59
0,31,41,1,2415,2537,122
0,31,51,3,2537,2553,16
0,31,54,3,2553,2570,17
0,31,40,1,2570,2681,111
0,31,48,3,2681,2692,11
0,31,46,3,2692,2709,17
0,31,45,3,2719,2731,12
0,31,53,1,2731,2813,82
0,31,37,3,2813,2825,12
0,31,50,3,2836,2843,7
0,31,56,3,2843,2858,15
0,31,30,3,2858,2874,16
0,31,47,3,3027,3042,15
0,31,44,3,3147,3157,10
0,31,49,3,3299,3306,7
0,31,33,3,3390,3398,8
0,31,31,3,3836,3853,17
0,31,40,3,4116,4129,13
0,31,52,3,4462,4476,14
0,31,53,3,4605,4616,11
0,31,41,3,4832,4849,17
0,32,36,5,536,562,26
0,32,32,5,618,635,17
0,32,38,5,1333,1342,9
0,32,39,5,1863,1881,18
0,32,57,5,1955,1968,13
0,32,43,5,2057,2071,14
0,32,42,5,2158,2167,9
0,32,55,5,2236,2253,17
0,32,34,5,2274,2286,12
0,32,35,5,2344,2358,14
0,32,54,5,2662,2673,11
0,32,48,5,2769,2792,23
0,32,46,5,2809,2823,14
0,32,50,5,2925,2939,14
0,32,45,5,3096,3109,13
0,32,56,5,3242,3258,16
0,32,44,5,3329,3345,16
0,32,37,5,3382,3396,14
0,32,33,5,3443,3456,13
0,32,49,5,3541,3560,19
0,32,30,5,3618,3631,13
0,32,51,5,3715,3725,10
0,32,47,5,3781,3803,22
0,32,31,5,3916,3942,26
0,32,40,5,4182,4193,11
0,32,52,5,4567,4591,24
0,32,53,5,4713,4734,21
0,32,41,5,5076,5088,12
0,33,36,6,562,594,32
0,33,32,6,635,671,36
0,33,38,6,1342,1362,20
0,33,39,6,1881,1903,22
0,33,57,6,1968,2016,48
0,33,43,6,2071,2115,44
0,33,42,6,2167,2214,47
0,33,55,6,2253,2289,36
0,33,34,6,2289,2319,30
0,33,35,6,2358,2406,48
0,33,54,6,2673,2716,43
0,33,48,6,2792,2820,28
0,33,46,6,2823,2845,22
0,33,50,6,2939,2987,48
0,33,45,6,3109,3129,20
0,33,56,6,3258,3280,22
0,33,44,6,3345,3395,50
0,33,37,6,3396,3434,38
0,33,33,6,3456,3494,38
0,33,49,6,3560,3596,36
0,33,30,6,3631,3649,18
0,33,51,6,3725,3744,19
0,33,47,6,3803,3824,21
0,33,31,6,3942,3990,48
0,33,40,6,4193,4215,22
0,33,52,6,4591,4613,22
0,33,53,6,4734,4782,48
0,33,41,6,5088,5122,34
0,34,36,7,594,644,50
0,34,32,7,671,746,75
0,34,38,7,1362,1413,51
0,34,39,7,1903,1976,73
0,34,57,7,2016,2104,88
0,34,55,7,2289,2332,43
0,34,42,7,2332,2417,85
0,34,35,7,2417,2472,55
0,34,34,7,2472,2518,46
0,34,54,7,2716,2751,35
0,34,48,7,2820,2857,37
0,34,50,7,2987,3017,30
0,34,45,7,3129,3179,50
0,34,56,7,3280,3363,83
0,34,44,7,3395,3476,81
0,34,33,7,3494,3524,30
0,34,49,7,3596,3627,31
0,34,30,7,3649,3706,57
0,34,51,7,3744,3820,76
0,34,47,7,3824,3869,45
0,34,31,7,3990,4065,75
0,34,52,7,4613,4692,79
0,34,53,7,4782,4844,62
0,34,41,7,5122,5159,37
0,35,36,9,715,728,13
0,35,32,9,782,789,7
0,35,38,9,1510,1521,11
0,35,39,9,2028,2039,11
0,35,43,9,2225,2238,13
0,35,57,9,2290,2296,6
0,35,55,9,2399,2406,7
0,35,42,9,2456,2472,16
0,35,35,9,2547,2560,13
0,35,34,9,2589,2600,11
0,35,54,9,2794,2810,16
0,35,46,9,2947,2958,11
0,35,50,9,3118,3132,14
0,35,45,9,3295,3312,17
0,35,48,9,3348,3359,11
0,35,56,9,3431,3437,6
0,35,37,9,3543,3551,8
0,35,44,9,3603,3617,14
0,35,49,9,3703,3711,8
0,35,33,9,3780,3792,12
0,35,30,9,3817,3826,9
0,35,51,9,3872,3888,16
0,35,47,9,3908,3915,7
0,35,31,9,4106,4119,13
0,35,40,9,4328,4344,16
0,35,52,9,4748,4759,11
0,35,53,9,4871,4882,11
0,35,41,9,5196,5208,12
0,36,76,1,0,13,13
0,36,67,6,1061,1585,524
0,36,64,6,1737,2057,320
0,36,58,6,2057,2444,387
0,36,59,6,2444,2719,275
0,36,65,6,2906,3339,433
0,36,66,6,3339,3630,291
0,37,75,1,0,20,20
0,37,69,6,2007,2374,367
0,37,62,6,2569,3041,472
0,37,75,6,3041,3439,398
0,38,61,6,976,1254,278
0,39,65,1,0,15,15
0,39,74,6,511,1197,686
0,39,60,6,1407,1892,485
0,39,71,6,1895,2377,482
0,39,70,6,2730,3048,318
0,41,63,1,0,14,14
0,41,68,6,805,1166,361
0,41,72,6,1316,1601,285
0,41,76,6,1621,2040,419
0,42,73,6,2171,2590,419
0,42,63,6,2590,2859,269
0,42,77,6,2859,3204,345
0,43,62,1,0,15,15
0,44,58,1,0,12,12
0,44,69,1,12,26,14
0,45,68,1,0,17,17
0,45,66,1,17,35,18
0,46,72,1,0,30,30
0,46,74,1,30,48,18
0,46,60,1,48,63,15
0,46,77,1,63,78,15
0,46,59,1,78,101,23
0,47,61,1,0,18,18
0,47,70,1,18,32,14
0,48,67,1,0,30,30
0,48,71,1,30,48,18
0,48,64,1,48,69,21
0,48,73,1,69,84,15
0,49,74,2,48,234,186
0,49,69,2,234,425,191
0,49,66,2,425,502,77
0,49,63,2,502,723,221
0,49,77,2,723,888,165
0,49,59,2,888,1023,135
0,49,70,2,1023,1102,79
0,50,75,2,20,186,166
0,50,67,2,186,295,109
0,50,68,2,295,418,123
0,50,72,2,418,556,138
0,50,61,2,556,701,145
0,50,58,2,701,899,198
0,50,71,2,899,1040,141
0,50,60,2,1040,1173,133
0,50,76,2,1173,1274,101
0,50,62,2,1274,1373,99
0,50,64,2,1373,1533,160
0,50,73,2,1533,1647,114
0,50,65,2,1647,1830,183
0,51,74,3,234,330,96
0,51,68,3,418,586,168
0,51,66,3,586,660,74
0,51,61,3,701,764,63
0,51,67,3,764,888,124
0,51,58,3,899,994,95
0,51,72,3,994,1111,117
0,51,60,3,1173,1245,72
0,51,75,3,1245,1415,170
0,51,76,3,1415,1500,85
0,51,64,3,1533,1597,64
0,51,71,3,1597,1737,140
0,51,69,3,1737,1877,140
0,51,63,3,1877,1943,66
0,51,73,3,1943,2030,87
0,51,59,3,2030,2181,151
0,51,77,3,2181,2349,168
0,51,62,3,2349,2467,118
0,51,70,3,2467,2589,122
0,51,65,3,2589,2744,155
0,52,74,4,330,373,43
0,52,68,4,586,659,73
0,52,66,4,660,706,46
0,52,61,4,764,843,79
0,52,67,4,888,949,61
0,52,58,4,994,1061,67
0,52,72,4,1111,1185,74
0,52,60,4,1245,1287,42
0,52,75,4,1415,1451,36
0,52,76,4,1500,1530,30
0,52,64,4,1597,1670,73
0,52,71,4,1737,1789,52
0,52,69,4,1877,1940,63
0,52,63,4,1943,2009,66
0,52,73,4,2030,2067,37
0,52,59,4,2181,2227,46
0,52,77,4,2349,2426,77
0,52,62,4,2467,2496,29
0,52,70,4,2589,2654,65
0,52,65,4,2744,2792,48
0,53,74,5,373,511,138
0,53,66,5,706,818,112
0,53,67,5,949,1061,112
0,53,58,5,1061,1143,82
0,53,76,5,1530,1621,91
0,53,75,5,1621,1723,102
0,53,69,5,1940,2007,67
0,53,73,5,2067,2171,104
0,53,63,5,2171,2271,100
0,53,77,5,2426,2543,117
0,53,70,5,2654,2730,76
0,53,65,5,2792,2906,114
0,54,68,5,659,805,146
0,54,61,5,843,976,133
0,54,72,5,1185,1316,131
0,54,60,5,1316,1407,91
0,54,64,5,1670,1737,67
0,54,71,5,1789,1895,106
0,54,59,5,2227,2388,161
0,54,62,5,2496,2569,73
0,55,139,1,0,668,668
0,55,142,2,683,1141,458
0,55,138,1,1141,2148,1007
0,55,138,2,2148,2587,439
0,55,142,3,2587,3505,918
0,55,132,3,3505,4071,566
0,55,143,2,4071,4650,579
0,55,152,3,4650,6382,1732
0,55,145,2,6382,7208,826
0,55,133,2,7208,8202,994
0,55,143,3,8202,8800,598
0,55,131,2,8800,9282,482
0,55,131,3,9282,9851,569
0,55,142,4,9851,11708,1857
0,55,152,5,11708,12920,1212
0,55,132,5,12920,13923,1003
0,55,132,6,13923,15127,1204
0,55,142,5,15127,17344,2217
0,55,138,6,17344,18799,1455
0,55,137,6,18799,20158,1359
0,55,136,4,20158,21374,1216
0,55,133,5,21374,23352,1978
0,55,144,5,23352,24362,1010
0,55,143,6,24362,26435,2073
0,55,144,6,26435,27692,1257
0,56,142,1,0,683,683
0,56,143,1,683,1460,777
0,56,152,1,1460,2029,569
0,56,152,2,2029,2733,704
0,56,145,1,2733,3632,899
0,56,131,1,3632,4615,983
0,56,144,1,4615,5306,691
0,56,136,1,5306,6045,739
0,56,133,1,6045,6731,686
0,56,132,4,6731,7824,1093
0,56,130,3,7824,8906,1082
0,56,138,4,8906,10050,1144
0,56,144,3,10050,10560,510
0,56,133,3,10560,11161,601
0,56,137,4,11161,12456,1295
0,56,136,3,12456,13160,704
0,56,137,5,13160,14701,1541
0,56,138,5,14701,16030,1329
0,56,130,5,16030,17788,1758
0,56,145,4,17788,19416,1628
0,56,143,4,19416,20559,1143
0,56,143,5,20559,22154,1595
0,56,145,6,22154,23324,1170
0,56,133,6,23352,24401,1049
0,56,136,5,24401,25437,1036
0,56,139,6,25437,27751,2314
0,57,137,1,0,926,926
0,57,132,1,926,1978,1052
0,57,132,2,1978,2632,654
0,57,139,2,2632,3068,436
0,57,130,1,3068,4425,1357
0,57,139,3,4425,5122,697
0,57,138,3,5122,5721,599
0,57,137,2,5721,6342,621
0,57,130,2,6342,6762,420
0,57,144,2,6762,7223,461
0,57,136,2,7223,7765,542
0,57,152,4,7765,10070,2305
0,57,137,3,10070,10651,581
0,57,144,4,10651,11913,1262
0,57,130,4,11913,13088,1175
0,57,131,4,13088,14737,1649
0,57,131,5,14737,15855,1118
0,57,145,3,15855,16461,606
0,57,133,4,16461,17925,1464
0,57,142,6,17925,19004,1079
0,57,131,6,19004,20458,1454
0,57,145,5,20458,21481,1023
0,57,139,4,21481,22620,1139
0,57,139,5,22620,24327,1707
0,57,130,6,24327,25462,1135
0,57,136,6,25462,27252,1790
0,58,79,1,0,3312,3312
0,58,81,1,3312,7300,3988
0,58,84,1,7300,10132,2832
0,59,83,1,0,2738,2738
0,59,78,1,2738,5091,2353
0,59,82,1,5091,6998,1907
0,59,80,1,6998,9399,2401
0,60,150,1,0,424,424
0,60,85,1,424,456,32
0,60,149,1,456,669,213
0,60,153,2,1111,1361,250
0,60,155,2,1365,1783,418
0,60,83,2,2738,3095,357
0,60,79,2,3312,3568,256
0,60,156,2,3974,4278,304
0,60,78,2,5091,5388,297
0,60,162,2,5489,5856,367
0,60,82,2,6998,7250,252
0,60,81,2,7300,7770,470
0,60,157,3,7770,7996,226
0,60,154,7,8256,8906,650
0,60,160,2,8906,9133,227
0,60,80,2,9399,9698,299
0,60,84,2,10132,10487,355
0,60,166,3,10738,11017,279
0,60,140,7,11017,11442,425
0,60,152,6,12920,13087,167
0,60,134,7,13087,13400,313
0,60,158,3,13700,14192,492
0,60,141,7,14192,14470,278
0,60,135,7,14470,14947,477
0,60,132,7,15127,15275,148
0,60,164,3,15275,15776,501
0,60,138,7,18799,18906,107
0,60,142,7,19004,19078,74
0,60,137,7,20158,20313,155
0,60,131,7,20458,20649,191
0,60,145,7,23324,23444,120
0,60,133,7,24401,24571,170
0,60,130,7,25462,25621,159
0,60,143,7,26435,26631,196
0,60,136,7,27252,27438,186
0,60,144,7,27692,27882,190
0,60,139,7,27882,28076,194
0,61,149,2,669,1651,982
0,61,155,3,1783,2752,969
0,61,83,3,3095,3864,769
0,61,79,3,3864,4821,957
0,61,78,3,5388,5899,511
0,61,162,3,5899,6522,623
0,61,156,3,6522,7125,603
0,61,81,3,7770,8681,911
0,61,82,3,8681,9499,818
0,61,160,3,9499,10165,666
0,61,84,3,10487,11196,709
0,61,166,4,11196,11938,742
0,61,157,4,11938,12391,453
0,61,152,7,13087,13623,536
0,61,158,4,14192,15045,853
0,61,132,8,15275,16234,959
0,61,80,3,16234,16990,756
0,61,164,4,16990,17507,517
0,61,138,8,18906,19825,919
0,61,142,8,19825,20670,845
0,61,131,8,20670,21472,802
0,61,137,8,21472,22465,993
0,61,145,8,23444,24017,573
0,61,133,8,24571,25190,619
0,61,130,8,25621,26015,394
0,61,143,8,26631,27292,661
0,61,136,8,27438,27956,518
0,61,144,8,27956,28434,478
0,61,139,8,28434,28878,444
0,62,149,4,1943,2141,198
0,62,150,4,2872,2999,127
0,62,153,4,3839,4069,230
0,62,79,4,4821,5027,206
0,62,156,4,7125,7295,170
0,62,82,4,9499,9836,337
0,62,84,4,11196,11607,411
0,62,157,5,12391,12613,222
0,62,140,10,12710,12814,104
0,62,152,8,13623,13891,268
0,62,134,9,13891,14169,278
0,62,141,9,16572,16842,270
0,62,164,5,17507,17732,225
0,62,142,9,20670,20944,274
0,62,131,9,21472,21790,318
0,62,136,10,28515,28768,253
0,63,155,4,2752,2916,164
0,63,85,4,3069,3215,146
0,63,83,4,3864,4048,184
0,63,78,4,5899,6161,262
0,63,162,4,6522,6842,320
0,63,81,4,8681,8857,176
0,63,160,4,10165,10330,165
0,63,154,9,10330,10481,151
0,63,166,5,11938,12391,453
0,63,158,5,15045,15301,256
0,63,80,4,16990,17304,314
0,63,132,10,17304,17741,437
0,63,135,10,17741,18105,364
0,63,138,9,19825,20088,263
0,63,137,9,22465,22667,202
0,63,145,9,24017,24396,379
0,63,133,9,25190,25439,249
0,63,130,10,26539,26766,227
0,63,143,9,27292,27613,321
0,63,144,9,28434,28740,306
0,63,139,9,28878,29087,209
0,64,85,2,456,1657,1201
0,64,150,2,1657,2531,874
0,64,150,3,2531,2872,341
0,64,85,3,2872,3069,197
0,64,153,3,3069,3839,770
0,64,154,8,8906,10079,1173
0,64,140,8,11442,12371,929
0,64,140,9,12371,12710,339
0,64,134,8,13400,13855,455
0,64,135,8,14947,16011,1064
0,64,141,8,16011,16572,561
0,64,135,9,16572,16723,151
0,65,91,1,0,57,57
0,65,107,1,57,119,62
0,65,113,1,119,145,26
0,65,115,2,145,647,502
0,65,92,2,647,845,198
0,65,108,1,845,870,25
0,65,112,3,870,1333,463
0,65,90,2,1333,1613,280
0,65,98,2,1613,1891,278
0,65,113,2,1891,2090,199
0,65,116,2,2090,2276,186
0,65,89,2,2276,2542,266
0,65,87,3,2542,2757,215
0,65,114,3,2757,3011,254
0,65,116,3,3011,3293,282
0,65,109,3,3293,3658,365
0,65,93,3,3658,3890,232
0,66,88,1,0,56,56
0,66,90,1,56,113,57
0,66,114,1,113,144,31
0,66,88,2,144,438,294
0,66,93,1,438,467,29
0,66,92,1,467,516,49
0,66,102,3,516,750,234
0,66,111,1,750,778,28
0,66,103,2,778,983,205
0,66,115,3,983,1186,203
0,66,104,3,1186,1413,227
0,66,107,2,1413,1703,290
0,66,97,2,1703,1990,287
0,66,101,3,1990,2305,315
0,66,108,3,2305,2518,213
0,66,100,2,2518,2905,387
0,66,111,2,2905,3148,243
0,67,105,1,0,57,57
0,67,87,1,57,96,39
0,67,115,1,96,145,49
0,67,112,1,145,171,26
0,67,117,1,171,195,24
0,67,106,1,195,235,40
0,67,117,2,235,618,383
0,67,101,2,618,863,245
0,67,98,1,863,923,60
0,67,99,2,938,1184,246
0,67,91,3,1184,1435,251
0,67,88,3,1435,1733,298
0,67,99,3,1733,2087,354
0,67,117,3,2087,2380,293
0,67,114,2,2380,2640,260
0,67,93,2,2640,2859,219
0,67,106,3,2859,3136,277
0,68,102,2,34,335,301
0,68,100,1,335,393,58
0,68,105,2,393,640,247
0,68,106,2,640,831,191
0,68,92,3,845,1221,376
0,68,96,1,1221,1428,207
0,68,108,2,1428,1693,265
0,68,107,3,1703,1956,253
0,68,113,3,2090,2483,393
0,68,90,3,2483,2707,224
0,68,95,3,2707,3009,302
0,68,111,3,3148,3385,237
0,68,89,3,3385,3676,291
0,69,102,1,0,34,34
0,69,86,1,34,62,28
0,69,104,1,62,120,58
0,69,86,2,120,316,196
0,69,112,2,316,695,379
0,69,105,3,695,913,218
0,69,94,1,913,940,27
0,69,94,2,940,1137,197
0,69,110,2,1137,1324,187
0,69,87,2,1324,1510,186
0,69,103,3,1510,1946,436
0,69,109,2,1946,2138,192
0,69,98,3,2138,2408,270
0,69,100,3,2905,3309,404
0,70,109,1,0,29,29
0,70,103,1,29,87,58
0,70,101,1,87,116,29
0,70,104,2,120,565,445
0,70,91,2,565,839,274
0,70,110,1,839,901,62
0,70,99,1,901,938,37
0,70,95,1,938,974,36
0,70,116,1,974,1000,26
0,70,97,1,1000,1051,51
0,70,89,1,1051,1091,40
0,70,95,2,1091,1443,352
0,70,96,2,1443,1652,209
0,70,86,3,1652,1970,318
0,70,94,3,1970,2184,214
0,70,97,3,2184,2490,306
0,70,110,3,2490,2710,220
0,71,102,4,750,826,76
0,71,105,4,913,981,68
0,71,115,4,1186,1256,70
0,71,92,4,1256,1308,52
0,71,112,4,1333,1394,61
0,71,104,4,1413,1484,71
0,71,91,4,1484,1535,51
0,71,96,3,1652,1720,68
0,71,88,4,1733,1798,65
0,71,103,4,1946,2029,83
0,71,86,4,2029,2073,44
0,71,99,4,2087,2143,56
0,71,107,4,2143,2182,39
0,71,94,4,2184,2240,56
0,71,101,4,2305,2362,57
0,71,98,4,2408,2478,70
0,71,97,4,2490,2559,69
0,71,108,4,2559,2623,64
0,71,113,4,2623,2689,66
0,71,110,4,2710,2749,39
0,71,87,4,2757,2818,61
0,71,90,4,2818,2892,74
0,71,117,4,2892,2961,69
0,71,95,4,3009,3095,86
0,71,114,4,3095,3172,77
0,71,106,4,3172,3232,60
0,71,100,4,3309,3361,52
0,71,111,4,3385,3470,85
0,71,116,4,3470,3552,82
0,71,109,4,3658,3725,67
0,71,89,4,3725,3771,46
0,71,93,4,3890,3949,59
0,72,102,6,1333,1731,398
0,72,91,6,1918,2531,613
0,72,88,6,3659,4695,1036
0,72,112,6,4695,5360,665
0,72,86,6,7407,7878,471
0,72,94,6,7878,8897,1019
0,72,104,6,10010,10708,698
0,72,87,6,11077,11719,642
0,72,92,6,14594,15525,931
0,72,110,6,15525,16032,507
0,72,107,6,18087,18667,580
0,72,109,6,19118,19854,736
0,72,95,6,20978,21391,413
0,72,108,6,21531,21963,432
0,72,117,6,23649,24492,843
0,73,103,6,2300,2754,454
0,73,101,6,5744,6208,464
0,73,105,6,10664,11576,912
0,73,111,6,15147,16216,1069
0,73,96,5,17345,17938,593
0,73,113,6,17938,18421,483
0,73,115,6,18718,19317,599
0,73,114,6,20393,20898,505
0,73,98,6,20898,21740,842
0,73,97,6,21776,22396,620
0,73,100,6,22824,23367,543
0,73,106,6,23367,23856,489
0,73,116,6,23921,24558,637
0,73,90,6,24558,25473,915
0,73,89,6,25473,25941,468
0,73,99,6,25941,26725,784
0,73,93,6,26725,27178,453
0,74,148,1,0,103,103
0,74,118,1,103,196,93
0,74,148,2,196,342,146
0,75,123,2,88,203,115
0,75,128,2,203,505,302
0,75,122,2,505,704,199
0,75,120,2,704,841,137
0,75,121,2,841,949,108
0,76,149,3,1651,1943,292
0,76,132,9,16234,16784,550
0,76,130,9,26015,26539,524
0,76,136,9,27956,28515,559
0,77,141,1,0,876,876
0,77,140,1,876,1378,502
0,77,141,2,1378,1784,406
0,77,134,1,1784,2213,429
0,78,140,2,1378,1860,482
0,78,154,2,1860,3184,1324
0,78,141,3,3184,3206,22
0,78,134,2,3206,3614,408
0,78,135,2,3614,5090,1476
0,78,140,3,5090,5208,118
0,78,134,3,5208,5222,14
0,78,146,2,5222,6174,952
0,79,135,1,0,919,919
0,79,154,3,3184,3592,408
0,79,146,3,6174,7988,1814
0,80,153,1,0,1111,1111
0,80,141,4,3206,3584,378
0,80,140,4,5208,5727,519
0,80,140,5,5727,7160,1433
0,80,141,5,7160,9326,2166
0,80,140,6,9326,10499,1173
0,80,134,4,10499,11227,728
0,80,134,5,11227,12096,869
0,80,134,6,12096,12942,846
0,80,141,6,12942,13647,705
0,81,154,1,0,975,975
0,81,135,3,5090,5424,334
0,82,154,4,3592,4307,715
0,82,154,5,4307,6038,1731
0,82,154,6,6038,8256,2218
0,82,135,4,8256,8846,590
0,82,135,5,8846,11493,2647
0,82,135,6,11493,14230,2737
0,83,146,1,0,481,481
0,84,146,4,7988,8134,146
0,85,155,1,0,1365,1365
0,85,157,1,1365,2612,1247
0,85,157,2,2612,6965,4353
0,85,158,1,6965,10797,3832
0,86,156,1,0,3974,3974
0,86,158,2,10797,13700,2903
0,87,163,1,0,502,502
0,87,163,2,502,1564,1062
0,87,159,1,1564,2252,688
0,87,161,1,2252,3018,766
0,87,161,2,3018,3786,768
0,87,163,3,3786,4158,372
0,87,159,3,4158,4554,396
0,88,165,1,0,662,662
0,88,165,2,662,1258,596
0,88,165,3,1258,1977,719
0,88,159,2,2252,3038,786
0,88,161,3,3786,4438,652
0,89,165,4,1977,2263,286
0,89,163,4,4158,4395,237
0,89,161,4,4438,4732,294
0,89,159,4,4732,4837,105
0,90,166,1,0,3118,3118
0,90,164,1,3118,4817,1699
0,90,160,1,4817,8168,3351
0,91,162,1,0,5489,5489
0,91,166,2,5489,10738,5249
0,91,164,2,10738,15070,4332
0,92,2,1,0,17,17
0,92,17,1,17,202,185
0,92,19,1,202,371,169
0,92,26,1,371,590,219
0,92,26,2,590,780,190
0,92,21,1,780,948,168
0,92,11,1,948,1004,56
0,92,29,1,1004,1165,161
0,92,28,1,1165,1293,128
0,92,8,2,1293,1358,65
0,92,23,2,1358,1584,226
0,92,20,2,1584,1783,199
0,92,16,2,1783,1953,170
0,92,7,1,1953,2009,56
0,92,10,1,2009,2071,62
0,92,10,2,2071,2126,55
0,92,18,2,2126,2216,90
0,92,28,2,2216,2307,91
0,92,1,2,2307,2319,12
