,machine_num,job_num,operation_num,begin_time,end_time,operation_time
0,1,23,1,0,234,234
0,1,3,1,234,249,15
0,1,23,2,249,475,226
0,1,2,1,475,492,17
0,1,29,1,492,653,161
0,1,19,1,653,822,169
0,1,2,2,822,835,13
0,1,9,1,835,873,38
0,1,28,1,873,1001,128
0,1,13,1,1001,1047,46
0,1,18,2,1047,1137,90
0,1,9,2,1137,1255,118
0,1,10,2,1255,1310,55
0,1,17,1,1310,1495,185
0,1,27,2,1495,1731,236
0,1,17,2,1731,1898,167
0,1,8,2,1898,1963,65
0,1,21,1,1963,2131,168
0,1,4,2,2131,2137,6
0,1,53,7,4354,4384,30
0,2,26,1,0,261,261
0,2,25,1,261,474,213
0,2,3,2,474,484,10
0,2,15,1,484,654,170
0,2,26,2,654,807,153
0,2,24,2,807,904,97
0,2,12,1,904,942,38
0,2,19,2,942,1163,221
0,2,16,1,1163,1293,130
0,2,14,2,1293,1405,112
0,2,15,2,1405,1549,144
0,2,29,2,1549,1655,106
0,2,5,2,1655,1723,68
0,2,12,2,1723,1799,76
0,2,22,1,1799,1962,163
0,2,11,1,1962,1983,21
0,2,11,2,1983,2074,91
0,2,39,7,3216,3253,37
0,3,10,1,0,35,35
0,3,24,1,35,234,199
0,3,20,1,234,365,131
0,3,8,1,365,419,54
0,3,18,1,419,598,179
0,3,6,1,598,629,31
0,3,5,1,629,651,22
0,3,4,1,651,663,12
0,3,20,2,663,759,96
0,3,1,1,759,768,9
0,3,1,2,768,784,16
0,3,7,1,784,845,61
0,3,7,2,845,946,101
0,3,25,2,946,1063,117
0,3,14,1,1063,1195,132
0,3,27,1,1195,1356,161
0,3,16,2,1356,1536,180
0,3,13,2,1536,1638,102
0,3,6,2,1638,1693,55
0,3,28,2,1693,1823,130
0,3,22,2,1962,2051,89
0,3,42,7,2051,2097,46
0,3,21,2,2131,2217,86
0,3,41,7,5030,5067,37
0,4,3,3,484,845,361
0,4,1,3,845,1684,839
0,4,9,3,1684,1876,192
0,4,13,3,1876,2090,214
0,4,2,3,2090,2475,385
0,4,7,3,2475,2550,75
0,4,4,3,2550,3305,755
0,4,8,3,3305,3508,203
0,4,10,3,3508,3708,200
0,4,5,3,3708,3802,94
0,4,12,3,3802,3963,161
0,4,6,3,3963,4049,86
0,4,11,3,4049,4173,124
0,4,57,7,4173,4253,80
0,4,3,9,4352,4359,7
0,4,9,9,5843,5869,26
0,4,1,9,7384,7387,3
0,4,7,9,9055,9106,51
0,4,13,9,10103,10146,43
0,4,2,9,12253,12259,6
0,4,4,9,13316,13323,7
0,4,6,9,14689,14718,29
0,4,12,9,15637,15659,22
0,4,5,9,17447,17476,29
0,4,10,9,18206,18228,22
0,4,11,9,19020,19047,27
0,4,8,9,20228,20278,50
0,5,40,2,111,235,124
0,5,45,2,235,386,151
0,5,36,2,408,555,147
0,5,49,2,612,764,152
0,5,32,2,764,858,94
0,5,30,2,858,971,113
0,5,50,2,971,1088,117
0,5,3,4,1088,1127,39
0,5,51,2,1148,1307,159
0,5,42,2,1367,1501,134
0,5,33,2,1501,1592,91
0,5,56,2,1592,1657,65
0,5,1,4,1684,1700,16
0,5,52,2,1700,1846,146
0,5,43,2,1846,1931,85
0,5,35,2,1931,2065,134
0,5,44,2,2065,2185,120
0,5,48,2,2185,2305,120
0,5,9,4,2305,2452,147
0,5,2,4,2475,2519,44
0,5,47,2,2519,2615,96
0,5,38,2,2615,2766,151
0,5,54,2,2766,2914,148
0,5,39,2,2914,3068,154
0,5,34,2,3068,3197,129
0,5,7,4,3197,3267,70
0,5,13,4,3267,3414,147
0,5,31,2,3414,3540,126
0,5,37,2,3540,3670,130
0,5,4,4,3670,3703,33
0,5,10,4,3708,3838,130
0,5,55,2,3838,3901,63
0,5,57,2,3901,3962,61
0,5,12,4,3963,4034,71
0,5,53,2,4034,4177,143
0,5,11,4,4177,4333,156
0,5,5,4,4333,4440,107
0,5,6,4,4440,4613,173
0,5,8,4,4613,4708,95
0,5,46,2,4708,4777,69
0,5,41,2,4777,4881,104
0,6,20,3,759,1018,259
0,6,3,5,1127,1149,22
0,6,26,3,1149,1454,305
0,6,16,3,1536,1766,230
0,6,14,3,1766,2140,374
0,6,15,3,2140,2367,227
0,6,3,6,2367,3078,711
0,6,19,3,3078,3283,205
0,6,9,5,3283,3375,92
0,6,9,6,3375,4296,921
0,6,2,5,4296,4318,22
0,6,29,3,4318,4689,371
0,6,7,5,4689,4743,54
0,6,1,5,4743,4758,15
0,6,1,6,4758,5203,445
0,6,21,3,5203,5614,411
0,6,7,6,5614,6438,824
0,6,23,3,6438,6885,447
0,6,24,3,6885,7077,192
0,6,17,3,7077,7388,311
0,6,13,5,7388,7449,61
0,6,13,6,7449,8210,761
0,6,18,3,8210,8522,312
0,6,11,5,8522,8580,58
0,6,2,6,8580,9432,852
0,6,6,5,9432,9526,94
0,6,10,5,9526,9586,60
0,6,25,3,9586,9736,150
0,6,6,6,9736,10322,586
0,6,4,5,10322,10341,19
0,6,22,3,10341,10616,275
0,6,5,5,10616,10651,35
0,6,5,6,10651,11004,353
0,6,4,6,11004,11626,622
0,6,12,5,11626,11684,58
0,6,10,6,11684,12092,408
0,6,11,6,12092,12880,788
0,6,28,3,12880,13292,412
0,6,12,6,13292,13878,586
0,6,8,5,13878,13967,89
0,6,8,6,13967,14401,434
0,6,27,3,14401,14745,344
0,7,96,4,799,1378,579
0,7,104,5,1378,2033,655
0,7,95,5,2033,2618,585
0,7,98,5,2618,2993,375
0,7,3,7,3078,3537,459
0,7,94,5,3537,4182,645
0,7,9,7,4296,4766,470
0,7,97,5,4766,5011,245
0,7,1,7,5203,5827,624
0,7,92,5,5827,6327,500
0,7,7,7,6438,7389,951
0,7,106,5,7389,7831,442
0,7,116,5,7831,8103,272
0,7,13,7,8210,9178,968
0,7,2,7,9432,10237,805
0,7,6,7,10322,10682,360
0,7,91,5,10682,11065,383
0,7,86,5,11065,11508,443
0,7,4,7,11626,12302,676
0,7,5,7,12302,12970,668
0,7,110,5,12970,13602,632
0,7,103,5,13602,13873,271
0,7,12,7,13878,14358,480
0,7,10,7,14358,15350,992
0,7,11,7,15350,16101,751
0,7,8,7,16101,16635,534
0,7,114,5,16635,17023,388
0,7,109,5,17023,17423,400
0,7,102,5,17423,17930,507
0,7,112,5,17930,18315,385
0,7,90,5,18315,18827,512
0,7,101,5,18827,19400,573
0,7,87,5,19400,19813,413
0,7,99,5,19813,20394,581
0,7,113,5,20394,20742,348
0,7,108,5,20742,21295,553
0,7,107,5,21295,21689,394
0,7,105,5,21689,22343,654
0,7,115,5,22343,22974,631
0,7,100,5,22974,23398,424
0,7,117,5,23398,23781,383
0,7,111,5,23781,24334,553
0,7,93,5,24334,24664,330
0,7,89,5,24664,24953,289
0,7,88,5,24953,25479,526
0,8,3,8,3537,4352,815
0,8,9,8,4766,5843,1077
0,8,1,8,5843,7384,1541
0,8,7,8,7389,9055,1666
0,8,13,8,9178,10103,925
0,8,2,8,10237,12253,2016
0,8,4,8,12302,13316,1014
0,8,6,8,13316,14689,1373
0,8,12,8,14689,15637,948
0,8,5,8,15637,17447,1810
0,8,10,8,17447,18206,759
0,8,11,8,18206,19020,814
0,8,8,8,19020,20228,1208
0,9,125,2,215,361,146
0,9,126,2,564,905,341
0,9,28,6,13408,13497,89
0,10,151,1,0,128,128
0,10,125,1,128,215,87
0,10,151,2,215,349,134
0,10,148,2,349,476,127
0,10,14,6,2258,2337,79
0,10,10,10,18228,18305,77
0,11,123,2,133,273,140
0,11,124,2,273,395,122
0,11,20,6,1146,1228,82
0,11,2,11,12307,12320,13
0,11,6,10,14718,14827,109
0,11,5,10,17476,17554,78
0,12,123,1,0,133,133
0,12,19,6,3535,3615,80
0,12,7,11,9226,9282,56
0,12,13,11,10282,10330,48
0,12,22,6,10703,10789,86
0,12,4,10,13323,13363,40
0,12,8,11,20393,20459,66
0,13,16,6,1862,1958,96
0,14,127,1,0,120,120
0,14,118,2,123,243,120
0,15,128,1,0,108,108
0,15,24,6,7220,7336,116
0,15,17,6,7557,7638,81
0,15,27,6,14877,14967,90
0,15,6,11,14967,15033,66
0,15,10,11,18305,18352,47
0,16,121,1,0,81,81
0,16,122,2,209,331,122
0,16,15,6,2510,2593,83
0,16,21,6,5706,5804,98
0,16,9,10,5869,6013,144
0,16,9,11,6013,6103,90
0,16,18,6,8610,8725,115
0,16,12,10,15659,15745,86
0,17,124,1,0,118,118
0,17,119,2,814,947,133
0,17,26,6,1555,1655,100
0,17,3,10,4359,4389,30
0,17,13,10,10146,10282,136
0,17,4,11,13363,13376,13
0,17,11,11,19141,19200,59
0,18,148,1,0,120,120
0,18,120,2,150,279,129
0,18,129,2,301,603,302
0,18,121,2,603,712,109
0,18,119,1,712,814,102
0,18,3,11,4389,4421,32
0,18,23,6,7014,7106,92
0,18,1,10,7387,7433,46
0,18,25,6,9879,9987,108
0,18,8,10,20278,20393,115
0,19,127,2,120,428,308
0,19,29,6,4769,4876,107
0,19,1,11,7433,7461,28
0,19,7,10,9106,9226,120
0,19,2,10,12259,12307,48
0,19,12,11,15745,15792,47
0,19,5,11,17554,17609,55
0,20,118,1,0,123,123
0,20,122,1,123,209,86
0,20,129,1,209,301,92
0,20,11,10,19047,19141,94
0,21,20,7,1228,1343,115
0,21,26,7,1655,1846,191
0,21,16,7,1958,2098,140
0,21,14,7,2337,2417,80
0,21,15,7,2593,2724,131
0,21,19,7,3615,3699,84
0,21,3,12,4421,4444,23
0,21,29,7,4876,5057,181
0,21,21,7,5804,6016,212
0,21,9,12,6103,6205,102
0,21,23,7,7106,7326,220
0,21,24,7,7336,7527,191
0,21,1,12,7527,7543,16
0,21,17,7,7638,7814,176
0,21,18,7,8725,8822,97
0,21,7,12,9282,9425,143
0,21,25,7,9987,10110,123
0,21,13,12,10330,10433,103
0,21,22,7,10789,11006,217
0,21,2,12,12320,12363,43
0,21,4,12,13376,13413,37
0,21,28,7,13497,13646,149
0,21,27,7,14967,15048,81
0,21,6,12,15048,15107,59
0,21,12,12,15792,15908,116
0,21,5,12,17609,17670,61
0,21,10,12,18352,18437,85
0,21,11,12,19200,19312,112
0,21,8,12,20459,20559,100
0,22,3,13,4444,4563,119
0,22,24,9,7570,7668,98
0,22,25,9,10174,10251,77
0,23,19,9,3912,4019,107
0,23,23,9,7395,7541,146
0,23,17,9,7922,8016,94
0,23,18,9,8920,9012,92
0,23,13,13,10433,10571,138
0,23,5,13,17670,17788,118
0,24,15,9,3699,3781,82
0,24,1,13,7543,7630,87
0,24,22,9,11086,11197,111
0,24,2,13,12363,12492,129
0,24,27,9,15113,15198,85
0,24,12,13,15908,16049,141
0,25,9,13,6205,6345,140
0,25,8,13,20559,20651,92
0,26,16,9,2168,2248,80
0,26,14,9,2891,3046,155
0,26,20,9,4196,4266,70
0,26,4,13,13413,13621,208
0,26,11,13,19312,19523,211
0,27,26,9,1899,2010,111
0,27,29,9,5144,5234,90
0,27,21,9,6105,6183,78
0,27,7,13,9425,9537,112
0,27,28,9,13749,13830,81
0,27,6,13,15107,15220,113
0,27,10,13,18437,18535,98
0,28,20,4,1018,1069,51
0,28,26,4,1454,1510,56
0,28,30,4,1629,1706,77
0,28,16,4,1766,1795,29
0,28,42,4,1823,1924,101
0,28,45,4,1924,2022,98
0,28,51,4,2089,2186,97
0,28,14,4,2186,2223,37
0,28,36,4,2223,2327,104
0,28,33,4,2327,2372,45
0,28,15,4,2372,2434,62
0,28,48,4,2434,2511,77
0,28,35,4,2511,2581,70
0,28,49,4,2581,2679,98
0,28,40,4,2679,2732,53
0,28,43,4,2732,2805,73
0,28,56,4,2805,2900,95
0,28,32,4,2900,2982,82
0,28,52,4,2982,3073,91
0,28,39,4,3081,3176,95
0,28,44,4,3176,3263,87
0,28,47,4,3263,3329,66
0,28,54,4,3329,3421,92
0,28,19,4,3421,3455,34
0,28,34,4,3455,3493,38
0,28,50,4,3493,3575,82
0,28,38,4,3575,3671,96
0,28,37,4,3682,3735,53
0,28,31,4,3735,3798,63
0,28,55,4,3913,3991,78
0,28,57,4,3991,4064,73
0,28,53,4,4188,4285,97
0,28,29,4,4689,4729,40
0,28,46,4,4794,4834,40
0,28,41,4,4898,4984,86
0,28,21,4,5614,5663,49
0,28,23,4,6885,6964,79
0,28,24,4,7077,7147,70
0,28,17,4,7388,7465,77
0,28,18,4,8522,8551,29
0,28,25,4,9736,9802,66
0,28,22,4,10616,10659,43
0,28,28,4,13292,13324,32
0,28,27,4,14745,14793,48
0,29,20,5,1069,1146,77
0,29,26,5,1510,1555,45
0,29,16,5,1795,1862,67
0,29,30,8,1862,1899,37
0,29,45,8,2105,2176,71
0,29,42,8,2176,2215,39
0,29,14,5,2223,2258,35
0,29,51,8,2291,2343,52
0,29,15,5,2434,2510,76
0,29,36,8,2510,2581,71
0,29,48,8,2599,2652,53
0,29,33,8,2652,2729,77
0,29,35,8,2729,2804,75
0,29,40,8,2841,2892,51
0,29,43,8,2929,2988,59
0,29,56,8,3021,3089,68
0,29,32,8,3110,3146,36
0,29,52,8,3198,3254,56
0,29,39,8,3254,3306,52
0,29,49,8,3306,3382,76
0,29,19,5,3455,3535,80
0,29,54,8,3535,3578,43
0,29,34,8,3581,3623,42
0,29,47,8,3623,3659,36
0,29,44,8,3659,3719,60
0,29,38,8,3751,3785,34
0,29,37,8,3832,3903,71
0,29,31,8,3947,3988,41
0,29,50,8,3988,4068,80
0,29,55,8,4087,4154,67
0,29,57,8,4253,4318,65
0,29,53,8,4384,4411,27
0,29,29,5,4729,4769,40
0,29,46,8,4919,4988,69
0,29,41,8,5067,5104,37
0,29,21,5,5663,5706,43
0,29,23,5,6964,7014,50
0,29,24,5,7147,7220,73
0,29,17,5,7465,7557,92
0,29,18,5,8551,8610,59
0,29,25,5,9802,9879,77
0,29,22,5,10659,10703,44
0,29,28,5,13324,13408,84
0,29,27,5,14793,14877,84
0,30,118,3,243,358,115
0,30,123,3,358,476,118
0,30,125,3,476,532,56
0,30,120,4,585,714,129
0,30,148,3,714,873,159
0,30,151,5,873,928,55
0,30,147,4,937,1159,222
0,30,118,5,1159,1207,48
0,30,147,5,1207,1246,39
0,30,128,3,1246,1447,201
0,30,124,3,1447,1595,148
0,30,126,3,1595,1796,201
0,30,26,8,1846,1899,53
0,30,127,4,1899,2214,315
0,30,122,4,2214,2384,170
0,30,121,3,2384,2454,70
0,30,119,3,2454,2586,132
0,30,121,6,2586,2730,144
0,30,148,4,2730,2905,175
0,30,123,4,2905,3114,209
0,30,119,4,3114,3210,96
0,30,124,4,3210,3330,120
0,30,122,5,3330,3382,52
0,30,123,5,3382,3431,49
0,30,124,5,3431,3490,59
0,30,151,6,3490,3673,183
0,30,129,4,3673,3840,167
0,30,122,6,3840,4079,239
0,30,20,8,4079,4196,117
0,30,147,6,4196,4473,277
0,30,124,6,4473,4741,268
0,30,148,6,4741,4877,136
0,30,21,8,6016,6105,89
0,30,23,8,7326,7395,69
0,30,17,8,7814,7922,108
0,30,22,8,11006,11086,80
0,30,28,8,13646,13749,103
0,31,151,3,349,449,100
0,31,120,3,449,585,136
0,31,122,3,585,673,88
0,31,151,4,673,798,125
0,31,147,3,847,937,90
0,31,118,4,937,1018,81
0,31,120,5,1018,1077,59
0,31,118,6,1207,1405,198
0,31,127,3,1405,1588,183
0,31,120,6,1588,1809,221
0,31,125,4,1809,1947,138
0,31,125,5,1947,1987,40
0,31,16,8,2098,2168,70
0,31,129,3,2168,2339,171
0,31,121,4,2454,2545,91
0,31,121,5,2545,2585,40
0,31,127,5,2585,2813,228
0,31,14,8,2813,2891,78
0,31,148,5,2905,2947,42
0,31,126,4,2947,3253,306
0,31,119,5,3253,3292,39
0,31,119,6,3292,3453,161
0,31,126,5,3453,3623,170
0,31,15,8,3623,3699,76
0,31,125,6,3699,3863,164
0,31,19,8,3863,3912,49
0,31,128,4,3912,4068,156
0,31,123,6,4068,4267,199
0,31,128,5,4267,4485,218
0,31,129,5,4485,4744,259
0,31,29,8,5057,5144,87
0,31,24,8,7527,7570,43
0,31,18,8,8822,8920,98
0,31,25,8,10110,10174,64
0,31,27,8,15048,15113,65
0,32,40,1,0,111,111
0,32,45,1,111,210,99
0,32,56,1,210,286,76
0,32,36,1,286,408,122
0,32,50,1,408,520,112
0,32,49,1,520,612,92
0,32,30,1,612,658,46
0,32,32,1,658,729,71
0,32,43,1,729,851,122
0,32,44,1,851,918,67
0,32,33,1,918,1019,101
0,32,51,1,1019,1148,129
0,32,37,1,1148,1264,116
0,32,42,1,1264,1367,103
0,32,35,1,1367,1446,79
0,32,52,1,1446,1532,86
0,32,54,1,1532,1613,81
0,32,30,3,1613,1629,16
0,32,31,1,1629,1688,59
0,32,45,3,1688,1700,12
0,32,47,1,1700,1812,112
0,32,42,3,1812,1823,11
0,32,32,3,1823,1839,16
0,32,48,1,1839,1888,49
0,32,34,1,1888,1950,62
0,32,39,1,1950,2064,114
0,32,35,3,2065,2073,8
0,32,51,3,2073,2089,16
0,32,36,3,2089,2099,10
0,32,40,3,2099,2112,13
0,32,33,3,2112,2120,8
0,32,49,3,2120,2127,7
0,32,56,3,2127,2142,15
0,32,43,3,2142,2158,16
0,32,52,3,2158,2172,14
0,32,50,3,2172,2179,7
0,32,44,3,2185,2195,10
0,32,38,1,2195,2277,82
0,32,48,3,2305,2316,11
0,32,46,1,2316,2440,124
0,32,57,1,2440,2532,92
0,32,55,1,2532,2618,86
0,32,53,1,2618,2700,82
0,32,47,3,2700,2715,15
0,32,38,3,2766,2777,11
0,32,41,1,2777,2899,122
0,32,54,3,2914,2931,17
0,32,39,3,3068,3081,13
0,32,34,3,3197,3204,7
0,32,31,3,3540,3557,17
0,32,37,3,3670,3682,12
0,32,55,3,3901,3913,12
0,32,57,3,3962,3973,11
0,32,53,3,4177,4188,11
0,32,46,3,4777,4794,17
0,32,41,3,4881,4898,17
0,33,30,5,1706,1719,13
0,33,42,5,1924,1933,9
0,33,45,5,2022,2035,13
0,33,51,5,2186,2196,10
0,33,36,5,2327,2353,26
0,33,33,5,2372,2385,13
0,33,48,5,2511,2534,23
0,33,35,5,2581,2595,14
0,33,49,5,2679,2698,19
0,33,40,5,2732,2743,11
0,33,43,5,2805,2819,14
0,33,56,5,2900,2916,16
0,33,32,5,2982,2999,17
0,33,52,5,3073,3097,24
0,33,39,5,3176,3194,18
0,33,44,5,3263,3279,16
0,33,47,5,3329,3351,22
0,33,54,5,3421,3432,11
0,33,34,5,3493,3505,12
0,33,50,5,3575,3589,14
0,33,38,5,3671,3680,9
0,33,37,5,3735,3749,14
0,33,31,5,3798,3824,26
0,33,55,5,3991,4008,17
0,33,57,5,4064,4077,13
0,33,53,5,4285,4306,21
0,33,46,5,4834,4848,14
0,33,41,5,4984,4996,12
0,34,30,6,1719,1737,18
0,34,42,6,1933,1980,47
0,34,45,6,2035,2055,20
0,34,51,6,2196,2215,19
0,34,36,6,2353,2385,32
0,34,33,6,2385,2423,38
0,34,48,6,2534,2562,28
0,34,35,6,2595,2643,48
0,34,49,6,2698,2734,36
0,34,40,6,2743,2765,22
0,34,43,6,2819,2863,44
0,34,56,6,2916,2938,22
0,34,32,6,2999,3035,36
0,34,52,6,3097,3119,22
0,34,39,6,3194,3216,22
0,34,44,6,3279,3329,50
0,34,47,6,3351,3372,21
0,34,54,6,3432,3475,43
0,34,34,6,3505,3535,30
0,34,50,6,3589,3637,48
0,34,38,6,3680,3700,20
0,34,37,6,3749,3787,38
0,34,31,6,3824,3872,48
0,34,55,6,4008,4044,36
0,34,57,6,4077,4125,48
0,34,53,6,4306,4354,48
0,34,46,6,4848,4870,22
0,34,41,6,4996,5030,34
0,35,30,7,1737,1794,57
0,35,45,7,2055,2105,50
0,35,51,7,2215,2291,76
0,35,33,7,2423,2453,30
0,35,36,7,2453,2503,50
0,35,48,7,2562,2599,37
0,35,35,7,2643,2698,55
0,35,49,7,2734,2765,31
0,35,40,7,2765,2841,76
0,35,43,7,2863,2929,66
0,35,56,7,2938,3021,83
0,35,32,7,3035,3110,75
0,35,52,7,3119,3198,79
0,35,44,7,3329,3410,81
0,35,47,7,3410,3455,45
0,35,54,7,3475,3510,35
0,35,34,7,3535,3581,46
0,35,50,7,3637,3667,30
0,35,38,7,3700,3751,51
0,35,37,7,3787,3832,45
0,35,31,7,3872,3947,75
0,35,55,7,4044,4087,43
0,35,46,7,4870,4919,49
0,36,30,9,1899,1908,9
0,36,45,9,2176,2193,17
0,36,42,9,2215,2231,16
0,36,51,9,2343,2359,16
0,36,36,9,2581,2594,13
0,36,48,9,2652,2663,11
0,36,33,9,2729,2741,12
0,36,35,9,2804,2817,13
0,36,40,9,2892,2908,16
0,36,43,9,2988,3001,13
0,36,56,9,3089,3095,6
0,36,32,9,3146,3153,7
0,36,52,9,3254,3265,11
0,36,39,9,3306,3317,11
0,36,49,9,3382,3390,8
0,36,54,9,3578,3594,16
0,36,34,9,3623,3634,11
0,36,47,9,3659,3666,7
0,36,44,9,3719,3733,14
0,36,38,9,3785,3796,11
0,36,37,9,3903,3911,8
0,36,31,9,3988,4001,13
0,36,50,9,4068,4082,14
0,36,55,9,4154,4161,7
0,36,57,9,4318,4324,6
0,36,53,9,4411,4422,11
0,36,46,9,4988,4999,11
0,36,41,9,5104,5116,12
0,37,69,6,818,1243,425
0,37,64,6,1761,2081,320
0,37,62,6,2399,2775,376
0,37,68,6,2861,3336,475
0,38,72,1,0,21,21
0,38,72,6,572,857,285
0,38,60,6,893,1279,386
0,38,71,6,1279,1564,285
0,38,70,6,2163,2438,275
0,39,75,6,686,1188,502
0,39,73,6,2246,2677,431
0,39,77,6,2677,2956,279
0,40,64,1,0,17,17
0,40,59,6,1355,2030,675
0,40,63,6,2030,2446,416
0,41,69,1,0,12,12
0,41,77,1,12,25,13
0,41,59,1,25,44,19
0,41,66,6,1694,2028,334
0,41,61,6,2296,2566,270
0,42,65,1,0,14,14
0,42,74,6,2655,3042,387
0,43,62,1,0,24,24
0,43,67,6,465,829,364
0,43,76,6,1466,1795,329
0,43,58,6,1795,2217,422
0,43,65,6,2769,3141,372
0,44,70,1,0,12,12
0,44,74,1,12,25,13
0,45,75,1,0,15,15
0,45,66,1,15,29,14
0,46,67,1,0,28,28
0,46,63,1,28,54,26
0,46,76,1,54,68,14
0,47,58,1,0,14,14
0,48,73,1,0,14,14
0,48,60,1,14,33,19
0,48,61,1,33,51,18
0,49,71,1,0,18,18
0,49,68,1,18,40,22
0,50,72,2,21,218,197
0,50,75,2,218,339,121
0,50,69,2,339,530,191
0,50,70,2,530,609,79
0,50,59,2,609,744,135
0,50,65,2,744,967,223
0,50,74,2,967,1153,186
0,51,67,2,28,137,109
0,51,60,2,137,270,133
0,51,76,2,270,371,101
0,51,73,2,371,485,114
0,51,71,2,485,626,141
0,51,63,2,626,807,181
0,51,64,2,807,967,160
0,51,58,2,967,1165,198
0,51,68,2,1165,1288,123
0,51,66,2,1288,1405,117
0,51,77,2,1405,1589,184
0,51,62,2,1589,1688,99
0,51,61,2,1688,1833,145
0,52,67,3,137,261,124
0,52,72,3,261,378,117
0,52,75,3,378,548,170
0,52,69,3,548,688,140
0,52,60,3,688,760,72
0,52,63,3,807,873,66
0,52,71,3,873,1013,140
0,52,59,3,1013,1164,151
0,52,58,3,1165,1260,95
0,52,76,3,1260,1345,85
0,52,66,3,1405,1479,74
0,52,64,3,1479,1543,64
0,52,77,3,1589,1757,168
0,52,61,3,1833,1896,63
0,52,70,3,1896,2018,122
0,52,73,3,2018,2105,87
0,52,62,3,2105,2223,118
0,52,65,3,2223,2378,155
0,52,74,3,2378,2474,96
0,52,68,3,2474,2642,168
0,53,67,4,261,322,61
0,53,72,4,378,452,74
0,53,75,4,548,584,36
0,53,69,4,688,751,63
0,53,60,4,760,802,42
0,53,63,4,873,939,66
0,53,71,4,1013,1065,52
0,53,59,4,1164,1210,46
0,53,58,4,1260,1327,67
0,53,76,4,1345,1375,30
0,53,66,4,1479,1525,46
0,53,64,4,1543,1616,73
0,53,77,4,1757,1834,77
0,53,61,4,1896,1975,79
0,53,70,4,2018,2083,65
0,53,73,4,2105,2142,37
0,53,62,4,2223,2252,29
0,53,65,4,2378,2426,48
0,53,74,4,2474,2517,43
0,53,68,4,2642,2715,73
0,54,72,5,452,572,120
0,54,75,5,584,686,102
0,54,69,5,751,818,67
0,54,71,5,1065,1180,115
0,54,59,5,1210,1355,145
0,54,76,5,1375,1466,91
0,54,58,5,1466,1548,82
0,54,73,5,2142,2246,104
0,54,62,5,2252,2399,147
0,54,74,5,2517,2655,138
0,54,65,5,2655,2769,114
0,55,67,5,322,465,143
0,55,60,5,802,893,91
0,55,63,5,939,1066,127
0,55,66,5,1525,1694,169
0,55,64,5,1694,1761,67
0,55,77,5,1834,1982,148
0,55,70,5,2083,2163,80
0,55,61,5,2163,2296,133
0,55,68,5,2715,2861,146
0,56,138,1,0,1007,1007
0,56,138,2,1007,1446,439
0,56,131,1,1446,2598,1152
0,56,133,2,2598,3592,994
0,56,131,2,3592,4074,482
0,56,131,3,4074,4643,569
0,56,142,2,4643,5101,458
0,56,145,2,5101,5927,826
0,56,142,3,5927,6845,918
0,56,139,1,6845,7513,668
0,56,143,2,7513,8092,579
0,56,143,3,8092,8690,598
0,56,152,3,8690,10422,1732
0,56,138,6,10422,11877,1455
0,56,142,5,11877,14094,2217
0,56,136,4,14094,15310,1216
0,56,132,5,15310,16313,1003
0,56,132,6,16313,17517,1204
0,56,133,5,17517,19495,1978
0,56,152,5,19495,20707,1212
0,56,137,5,20707,22599,1892
0,56,144,4,22599,23912,1313
0,56,137,6,23912,25271,1359
0,56,144,5,25271,26281,1010
0,56,144,6,26281,27538,1257
0,57,142,1,0,683,683
0,57,152,1,683,1252,569
0,57,133,1,1252,1938,686
0,57,145,1,1938,2837,899
0,57,136,1,2837,3576,739
0,57,143,1,3576,4353,777
0,57,138,4,4353,5497,1144
0,57,133,3,5497,6098,601
0,57,144,1,6098,6789,691
0,57,152,2,6789,7493,704
0,57,138,5,7493,8822,1329
0,57,144,3,8822,9332,510
0,57,132,4,9332,10425,1093
0,57,136,3,10425,11129,704
0,57,145,4,11129,12757,1628
0,57,152,4,12757,15293,2536
0,57,130,3,15293,16375,1082
0,57,143,4,16375,17518,1143
0,57,143,5,17518,19113,1595
0,57,137,4,19113,20408,1295
0,57,145,6,20408,21578,1170
0,57,136,5,21578,22614,1036
0,57,133,6,22614,23663,1049
0,57,130,5,23663,25421,1758
0,57,139,6,25421,27735,2314
0,58,132,1,0,1052,1052
0,58,132,2,1052,1706,654
0,58,138,3,1706,2305,599
0,58,130,1,2305,3662,1357
0,58,137,1,3662,4588,926
0,58,136,2,4588,5130,542
0,58,132,3,5130,5728,598
0,58,137,2,5728,6349,621
0,58,130,2,6349,6769,420
0,58,144,2,6789,7250,461
0,58,142,4,7250,8712,1462
0,58,139,2,8712,9148,436
0,58,145,3,9148,9754,606
0,58,131,4,9754,11403,1649
0,58,137,3,11403,11984,581
0,58,133,4,11984,13448,1464
0,58,139,3,13448,14145,697
0,58,131,5,14145,15263,1118
0,58,145,5,15263,16286,1023
0,58,131,6,16286,17740,1454
0,58,139,4,17740,18879,1139
0,58,130,4,18879,20054,1175
0,58,142,6,20054,21133,1079
0,58,139,5,21133,22840,1707
0,58,136,6,22840,24630,1790
0,58,143,6,24630,26035,1405
0,58,130,6,26035,27170,1135
0,59,84,1,0,2832,2832
0,59,81,1,2832,6820,3988
0,59,80,1,6820,10724,3904
0,60,83,1,0,2738,2738
0,60,79,1,2738,6112,3374
0,60,82,1,6112,8019,1907
0,60,78,1,8019,10372,2353
0,61,85,1,0,32,32
0,61,149,1,32,245,213
0,61,150,1,245,669,424
0,61,153,2,1111,1361,250
0,61,83,2,2738,3095,357
0,61,84,2,3095,3450,355
0,61,156,2,3974,4278,304
0,61,162,2,5329,5696,367
0,61,79,2,6112,6368,256
0,61,155,2,6474,6892,418
0,61,81,2,6892,7362,470
0,61,154,7,7362,8012,650
0,61,82,2,8019,8271,252
0,61,140,7,8371,8796,425
0,61,134,7,8796,9109,313
0,61,157,3,9432,9658,226
0,61,166,3,9953,10232,279
0,61,78,2,10372,10669,297
0,61,80,2,10724,11023,299
0,61,141,7,11242,11520,278
0,61,138,7,11877,11984,107
0,61,160,2,13304,13531,227
0,61,158,3,13991,14483,492
0,61,135,7,14483,14960,477
0,61,164,3,16195,16696,501
0,61,132,7,17517,17665,148
0,61,131,7,17740,17931,191
0,61,152,6,20707,20874,167
0,61,142,7,21133,21207,74
0,61,145,7,21578,21698,120
0,61,133,7,23663,23833,170
0,61,136,7,24630,24816,186
0,61,137,7,25271,25426,155
0,61,143,7,26035,26231,196
0,61,130,7,27170,27329,159
0,61,144,7,27538,27728,190
0,61,139,7,27735,27929,194
0,62,149,2,245,1227,982
0,62,83,3,3095,3864,769
0,62,156,3,4278,4881,603
0,62,84,3,4881,5590,709
0,62,162,3,5696,6319,623
0,62,79,3,6368,7325,957
0,62,81,3,7362,8273,911
0,62,155,3,8273,9242,969
0,62,157,4,9658,10111,453
0,62,166,4,10232,10974,742
0,62,82,3,10974,11792,818
0,62,138,8,11984,12903,919
0,62,78,3,12903,13414,511
0,62,160,3,13531,14197,666
0,62,158,4,14483,15336,853
0,62,80,3,15336,16092,756
0,62,164,4,16696,17213,517
0,62,131,8,17931,18733,802
0,62,132,8,18733,19692,959
0,62,142,8,21207,22052,845
0,62,152,7,22052,22588,536
0,62,145,8,22588,23161,573
0,62,133,8,23833,24452,619
0,62,136,8,24816,25334,518
0,62,137,8,25426,26419,993
0,62,143,8,26419,27080,661
0,62,130,8,27329,27723,394
0,62,144,8,27728,28206,478
0,62,139,8,28206,28650,444
0,63,149,4,1519,1717,198
0,63,153,4,2131,2361,230
0,63,83,4,3864,4207,343
0,63,156,4,4881,5051,170
0,63,84,4,5590,6001,411
0,63,162,4,6319,6526,207
0,63,81,4,8273,8588,315
0,63,155,4,9242,9409,167
0,63,157,5,10111,10333,222
0,63,134,9,10908,11186,278
0,63,82,4,11792,12129,337
0,63,131,9,18733,19051,318
0,63,132,10,20242,20487,245
0,63,142,9,22052,22326,274
0,63,133,9,24452,24692,240
0,63,136,10,25893,26146,253
0,63,130,10,28247,28466,219
0,64,85,4,3202,3348,146
0,64,150,4,3543,3688,145
0,64,79,4,7325,7763,438
0,64,154,9,9185,9336,151
0,64,140,10,10453,10567,114
0,64,166,5,10974,11427,453
0,64,141,9,12081,12333,252
0,64,138,9,12903,13166,263
0,64,78,4,13414,13676,262
0,64,160,4,14197,14362,165
0,64,158,5,15336,15592,256
0,64,80,4,16092,16406,314
0,64,135,10,16406,16770,364
0,64,164,5,17213,17379,166
0,64,152,8,22588,22925,337
0,64,145,9,23161,23540,379
0,64,137,9,26419,26621,202
0,64,143,9,27080,27401,321
0,64,144,9,28206,28512,306
0,64,139,9,28650,28859,209
0,65,85,2,32,1233,1201
0,65,153,3,1361,2131,770
0,65,150,2,2131,3005,874
0,65,85,3,3005,3202,197
0,65,150,3,3202,3543,341
0,65,154,8,8012,9185,1173
0,65,140,8,9185,10114,929
0,65,140,9,10114,10453,339
0,65,134,8,10453,10908,455
0,65,141,8,11520,12081,561
0,65,135,8,14960,16024,1064
0,65,135,9,16024,16175,151
0,66,100,1,0,25,25
0,66,116,1,25,55,30
0,66,108,1,55,80,25
0,66,99,1,80,136,56
0,66,91,2,136,324,188
0,66,102,2,324,624,300
0,66,98,2,647,925,278
0,66,86,2,925,1208,283
0,66,113,2,1208,1407,199
0,66,114,3,1407,1661,254
0,66,92,3,1661,2005,344
0,66,87,1,2005,2060,55
0,66,116,3,2060,2342,282
0,66,87,2,2342,2568,226
0,66,93,3,2812,3044,232
0,66,109,3,3292,3657,365
0,67,107,1,0,44,44
0,67,104,1,44,102,58
0,67,93,1,102,131,29
0,67,96,1,131,357,226
0,67,92,2,357,549,192
0,67,116,2,549,1046,497
0,67,95,1,1046,1078,32
0,67,104,3,1078,1305,227
0,67,106,2,1305,1576,271
0,67,103,1,1576,1635,59
0,67,102,3,1635,1869,234
0,67,103,2,1869,2074,205
0,67,105,1,2074,2128,54
0,67,112,2,2128,2351,223
0,67,86,3,2351,2590,239
0,67,87,3,2590,2892,302
0,68,117,1,0,24,24
0,68,102,1,24,61,37
0,68,114,2,61,321,260
0,68,113,1,321,350,29
0,68,117,3,362,655,293
0,68,89,1,655,682,27
0,68,97,2,682,932,250
0,68,115,2,932,1131,199
0,68,89,2,1131,1319,188
0,68,91,3,1319,1570,251
0,68,108,3,1570,1777,207
0,68,101,2,1777,2022,245
0,68,88,3,4317,4615,298
0,69,114,1,0,41,41
0,69,107,2,44,469,425
0,69,108,2,469,734,265
0,69,106,1,734,790,56
0,69,109,1,790,813,23
0,69,111,1,813,834,21
0,69,107,3,834,1087,253
0,69,111,2,1087,1395,308
0,69,110,1,1395,1420,25
0,69,95,3,1420,1722,302
0,69,113,3,1722,2115,393
0,69,115,3,2115,2479,364
0,69,112,3,2479,2745,266
0,69,90,3,2745,2969,224
0,69,100,3,2969,3451,482
0,70,91,1,0,54,54
0,70,117,2,54,362,308
0,70,86,1,362,390,28
0,70,104,2,390,611,221
0,70,98,1,611,647,36
0,70,99,2,647,868,221
0,70,94,2,868,1065,197
0,70,95,2,1078,1309,231
0,70,98,3,1309,1579,270
0,70,89,3,1579,2003,424
0,70,106,3,2003,2226,223
0,70,94,3,2226,2457,231
0,70,99,3,2457,2866,409
0,70,105,3,3083,3301,218
0,71,92,1,0,41,41
0,71,101,1,41,70,29
0,71,112,1,70,112,42
0,71,115,1,112,163,51
0,71,100,2,163,405,242
0,71,97,1,405,456,51
0,71,88,1,456,482,26
0,71,94,1,482,522,40
0,71,96,2,522,731,209
0,71,90,1,731,753,22
0,71,97,3,932,1238,306
0,71,110,2,1420,1734,314
0,71,90,2,1734,1985,251
0,71,110,3,1985,2205,220
0,71,111,3,2205,2522,317
0,71,93,2,2522,2812,290
0,71,105,2,2812,3083,271
0,71,109,2,3083,3292,209
0,71,101,3,3292,3603,311
0,71,103,3,3603,4083,480
0,71,88,2,4083,4317,234
0,72,117,4,655,724,69
0,72,96,3,731,799,68
0,72,107,4,1087,1126,39
0,72,97,4,1238,1307,69
0,72,104,4,1307,1378,71
0,72,98,4,1579,1649,70
0,72,91,4,1649,1700,51
0,72,95,4,1722,1808,86
0,72,102,4,1869,1945,76
0,72,92,4,2005,2057,52
0,72,89,4,2057,2103,46
0,72,113,4,2115,2181,66
0,72,106,4,2226,2286,60
0,72,110,4,2286,2325,39
0,72,114,4,2325,2402,77
0,72,94,4,2457,2513,56
0,72,108,4,2513,2577,64
0,72,86,4,2590,2634,44
0,72,111,4,2634,2719,85
0,72,112,4,2745,2806,61
0,72,99,4,2866,2922,56
0,72,90,4,2969,3043,74
0,72,116,4,3043,3125,82
0,72,87,4,3125,3186,61
0,72,93,4,3186,3245,59
0,72,115,4,3245,3315,70
0,72,105,4,3315,3383,68
0,72,100,4,3451,3503,52
0,72,109,4,3657,3724,67
0,72,101,4,3724,3781,57
0,72,103,4,4083,4166,83
0,72,88,4,4615,4680,65
0,73,96,5,1378,2305,927
0,73,98,6,2993,4004,1011
0,73,94,6,4182,5201,1019
0,73,92,6,6327,7258,931
0,73,97,6,7258,8426,1168
0,73,91,6,11065,11678,613
0,73,110,6,13602,14109,507
0,73,102,6,17930,18328,398
0,73,87,6,19813,20455,642
0,73,108,6,21295,21727,432
0,73,117,6,23781,24624,843
0,73,111,6,24624,25572,948
0,73,88,6,25572,26608,1036
0,74,104,6,2033,3063,1030
0,74,95,6,3063,4229,1166
0,74,106,6,7831,8320,489
0,74,116,6,8320,8957,637
0,74,86,6,11508,12114,606
0,74,103,6,13873,14327,454
0,74,109,6,17423,17852,429
0,74,112,6,18315,19165,850
0,74,114,6,19165,19670,505
0,74,101,6,19670,20134,464
0,74,99,6,20394,21178,784
0,74,90,6,21178,22093,915
0,74,105,6,22343,23255,912
0,74,100,6,23398,23941,543
0,74,113,6,23941,24424,483
0,74,93,6,24664,25117,453
0,74,89,6,25117,25585,468
0,74,107,6,25585,26261,676
0,74,115,6,26261,26860,599
0,75,128,2,108,450,342
0,75,126,1,450,564,114
0,75,147,1,564,693,129
0,75,147,2,693,847,154
0,76,120,1,0,150,150
0,77,149,3,1227,1519,292
0,77,132,9,19692,20242,550
0,77,136,9,25334,25893,559
0,77,130,9,27723,28247,524
0,78,141,1,0,876,876
0,78,134,1,876,1305,429
0,78,140,2,1305,1976,671
0,78,141,2,1976,2382,406
0,78,141,3,2382,2406,24
0,78,134,3,2406,2425,19
0,78,140,3,2425,2589,164
0,79,134,2,1305,1713,408
0,79,146,2,1713,2665,952
0,79,135,2,3280,4756,1476
0,80,140,1,0,361,361
0,80,154,3,1945,2353,408
0,80,146,3,2665,4479,1814
0,81,153,1,0,1111,1111
0,81,134,4,2425,3153,728
0,81,141,4,3153,3531,378
0,81,140,4,3531,4050,519
0,81,134,5,4050,4919,869
0,81,140,5,4919,6352,1433
0,81,134,6,6352,7198,846
0,81,140,6,7198,8371,1173
0,81,141,5,8371,10537,2166
0,81,141,6,10537,11242,705
0,82,154,1,0,975,975
0,82,154,2,975,1945,970
0,82,135,1,1945,3280,1335
0,82,135,3,4756,5090,334
0,83,154,4,2353,3068,715
0,83,154,5,3068,4799,1731
0,83,154,6,4799,7017,2218
0,83,135,4,7017,7607,590
0,83,135,5,7607,10254,2647
0,83,135,6,10254,12991,2737
0,84,146,1,0,481,481
0,85,146,4,4479,4625,146
0,86,158,1,0,3832,3832
0,86,157,1,3832,5079,1247
0,86,157,2,5079,9432,4353
0,86,158,2,9432,13991,4559
0,87,156,1,0,3974,3974
0,87,155,1,3974,6474,2500
0,88,163,1,0,502,502
0,88,161,1,502,1268,766
0,88,161,2,1268,2036,768
0,88,163,3,2192,2564,372
0,88,159,3,3574,3970,396
0,89,165,1,0,662,662
0,89,159,1,662,1500,838
0,89,163,2,1500,2192,692
0,89,165,2,2192,2788,596
0,89,159,2,2788,3574,786
0,89,165,3,3574,4293,719
0,89,161,3,4293,4945,652
0,90,163,4,2564,2801,237
0,90,159,4,3970,4075,105
0,90,165,4,4293,4579,286
0,90,161,4,4945,5239,294
0,91,162,1,0,5329,5329
0,91,164,1,5329,7028,1699
0,91,166,2,7028,9953,2925
0,91,160,1,9953,13304,3351
0,91,164,2,13304,16195,2891
0,92,166,1,0,2794,2794
